12,16
-s---P-n--n-s-wr
-s-----n-sn3s---
sw-----n-sn-s-P-
s---eeeC-sn-Cnnn
s--------sn-----
----WWWWW--wwwww
-----EEEE--eeeee
n-------RSn---1-
n---eeeC-Sn-wwww
nw-----n2Sn-S---
-n--ec-n-Sn-S--e
-n--rn-n-Sn-S-n-

------y-y--y-y--
--y--g----------
--yjg----------j
----------------
---ug---m--b---j
----------------
yy--------------
---mg---u--t---j
----------------
--hjg--------y-j
--h---j---------
------h-h--h-h--
