12,16,3
-s---P-n--n-s-wr
-s-----n-sn3s---
sw-----n-sn-s-P-
s---eeeC-sn-Ceee
s--------sn-----
----WWWWW--wwwww
-----eeee--eeeee
n-------RSn---1-
n---wwwC-Sn-wwww
nw-----n2Sn-S---
-n--ec-n-Sn-S-ce
-n--rs-n-Sn-S-n-

------y-y--y-y--
--y--g----------
--yjg----------j
----------------
---ug---m--b---j
----------------
yy--------------
---mg---u--t---j
----------------
--hjg--------y-j
--h---j---------
------h-h--h-h--
