12,16
-s---P-n--n-s-wr
-s-----n-sn3s---
sw-----n-sn-s-P-
s---eeeC-sn-Cnnn
s--------sn-----
----WWWWW--wwwww
-----EEEE--eeeee
n-------RSn---1-
n---eeeC-Sn-wwww
nw-----n2Sn-S---
-n--nc-n-Sn-S--e
-n--rn-n-Sn-S-n-

------n-n--n-n--
--n--w----------
--new----------e
----------------
---zw---q--z---e
----------------
nn--------------
---qw---e--c---e
----------------
--sew--------n-e
--s---e---------
------s-s--s-s--
