12,16,3
-s---Pyny-nysynr
-sy--g-n-sn3s---
swyj---n-sn-s-Pj
s--heeec-sn-ceee
s--j----msnb---j
hh--WWWWW--wwwww
-----eeee--eeeee
n--m----RSnt--1j
n---wwwc-Sn-wwww
nw-j---n2Sn-S--j
-ny-eCjn-Sn-S-Ce
-ny-rshnhSnhS-n-

------y-y--y-y--
--y--g----------
--yjg----------j
----------------
---ug---m--b---j
----------------
yy--------------
----g---u--t---j
----------------
--hjg--------y-j
--h---j---------
------h-h--h-h--

----------------
----------------
----------------
----------------
----------------
----------------
----------------
----------------
----------------
-------------L--
-------------L--
-------------L--